
000000010000000000000100000000000100000000000001
000000010000000000000100000000000000000000000000
000000000000000000000100000000000100000000000000
000000000000000000000100000000000100000000000001
000000010000000000000100000000000100000000000001
000000010000000000000100000000000100000000000001
000000010000000000000100000000000100000000000001
000000010000000000000100000000000000000000000000
000000010000000000000100000000000100000000000000
000000010000000000000100000000000100000000000001
000000010000000000000100000000000100000000000001
000000010000000000000100000000000100000000000001
000000010000000000000100000000000000000000000000
000000010000000000000100000000000100000000000000
000000010000000000000100000000000100000000000001
000000010000000000000100000000000100000000000001
000000010000000000000100000000000100000000000001
000000010000000000000100000000000000000000000000
000000010000000000000100000000000100000000000000
000000010000000000000100000000000100000000000001
000000010000000000000100000000000100000000000001
000000010000000000000100000000000100000000000001
000000010000000000000100000000000000000000000000
000000010000000000000100000000000100000000000000
000000010000000000000100000000000100000000000001
000000010000000000000100000000000100000000000001
000000010000000000000100000000000100000000000001
000000010000000000000100000000000000000000000000
000000010000000000000100000000000100000000000000
000000010000000000000100000000000100000000000001
000000010000000000000100000000000100000000000001
000000010000000000000100000000000100000000000001
000000010000000000000100000000000000000000000000
000000010000000000000100000000000100000000000000
000000010000000000000100000000000100000000000001
000000010000000000000100000000000100000000000001
000000010000000000000100000000000100000000000001
000000010000000000000100000000000000000000000000
000000010000000000000100000000000100000000000000
000000010000000000000100000000000100000000000001
000000010000000000000100000000000100000000000001
000000010000000000000100000000000100000000000001
000000010000000000000100000000000000000000000000
000000010000000000000100000000000100000000000000
000000010000000000000100000000000100000000000001
000000010000000000000100000000000100000000000001
000000010000000000000100000000000100000000000001
